id,type,nodeNumber,nodeIDs
0,0,16,0,1,2,3,4,5,6,7,8,9,10,11,12,13,14,15
2,0,5,141,145,144,143,142
3,0,26,156,155,154,153,152,151,150,149,147,146,148,161,162,163,164,74,88,87,86,85,84,83,160,159,158,157
4,0,14,115,116,117,104,105,106,107,108,109,110,111,112,113,114
5,0,4,103,102,101,100
6,0,12,119,120,121,122,123,124,125,126,127,128,129,118
7,0,11,139,140,130,131,132,133,134,135,136,137,138
8,0,32,74,88,86,85,84,83,82,81,80,79,78,77,76,75,59,58,57,56,60,61,62,63,64,65,66,67,68,69,70,71,72,73
9,0,40,43,44,45,46,47,48,49,50,51,52,53,54,55,16,17,18,19,20,21,22,23,24,25,26,27,28,29,30,31,32,33,34,35,36,37,38,39,40,41,42
10,0,8,168,167,166,165,172,171,170,169
11,0,8,173,175,176,177,178,179,180,174
12,0,4,183,182,181,184
14,0,16,231,246,245,244,243,242,241,240,239,238,237,236,235,234,233,232
15,0,24,231,246,293,294,295,296,292,291,290,289,288,287,286,285,284,283,282,281,280,279,278,277,276,275
16,0,4,322,323,324,321
17,0,4,317,320,319,318
19,0,4,334,333,336,335
20,0,4,343,346,345,344
21,0,5,339,340,341,342,338
22,0,5,352,351,350,354,353
23,0,6,347,357,356,355,349,348
24,0,4,316,315,314,313
25,0,4,312,311,310,309
26,0,4,304,303,302,301
27,0,4,300,299,298,297
28,0,4,308,307,306,305
29,0,8,273,274,267,268,269,270,271,272
30,0,4,259,260,261,262
31,0,4,258,255,256,257
32,0,4,254,251,252,253
33,0,4,250,249,248,247
34,0,4,263,264,265,266
35,0,13,223,222,221,220,219,218,230,229,228,227,226,225,224
36,0,5,215,214,213,217,216
37,0,5,210,209,208,212,211
39,0,5,366,367,363,364,365
40,0,5,371,370,368,373,372
41,0,21,381,393,394,395,396,397,398,391,392,386,385,373,368,369,374,375,376,377,378,379,380
42,0,20,381,393,399,400,401,402,398,391,390,389,388,387,358,359,360,361,362,384,383,382
43,0,15,449,450,451,452,453,454,455,456,457,458,444,445,446,447,448
44,0,20,461,460,459,186,187,188,189,190,191,192,193,194,195,196,467,466,465,464,463,462
45,0,16,472,89,99,98,471,480,92,91,90,479,478,477,476,475,474,473
46,0,4,470,469,482,481
47,0,5,468,94,95,96,97
48,0,13,433,483,484,485,486,443,440,439,438,437,436,435,434
49,0,34,483,487,488,486,443,405,406,407,408,409,410,411,412,413,414,415,416,417,418,419,420,421,422,423,424,425,426,427,428,429,430,431,432,433
50,0,17,489,325,332,331,330,329,328,327,337,497,496,495,494,493,492,491,490
51,0,15,203,197,506,505,504,503,502,501,500,499,498,199,200,201,202
52,0,10,529,533,534,535,523,524,525,526,527,528
53,0,10,533,536,537,510,509,508,532,531,530,529
54,0,21,555,563,564,565,566,535,523,522,521,519,520,516,517,518,558,559,560,561,562,557,556
55,0,22,537,510,511,538,539,540,541,542,543,544,545,546,547,548,549,550,551,552,553,554,555,563
56,0,5,513,514,515,507,512
57,0,4,621,622,623,624
58,0,4,626,625,628,627
59,0,8,44,45,46,47,48,620,619,43
60,1,6,111,4,3,2,1,17
61,1,4,830,831,832,833
62,1,4,834,835,836,837
63,1,4,838,839,840,841
64,1,4,842,843,844,845
65,1,4,846,847,848,849
66,1,4,850,851,852,853
67,1,4,854,855,856,857
68,1,4,858,859,860,861